S........
2222...1.
...22221.
.2.33..1.
.2.3...1.
.2...3.1.
.2..33...
.22222222
........T