##......##.......##..##.........#.#..##.#........#...#...#.#
..#..#.#.#.#..#.#......#.#......##......#..##.#...#..#.#....
###.##.#...#...#.....##...#....#....#..#...#...##..........#
....##.....#####..........#..#.#...#....##..#...#.#.#.#...##
...#..##........#....#....#.#....#.###.#...###..#..#....##..
.#..#.#.#...#..#...#.........###..#....#.###.#.#.....##.####
.##...#.#..##.#..#.......#..##..#.###......#..##....#.#.###.
.....#....#.#...#..#..#.##..##....#.#.#.#.##.#.#.#....#.....
##....##.......#.##.##....#........#.....#..#........#......
.#...###.#.#.##....##..#......#....##...##....#............#
....#.#.#.#..#...#.#####..#........#.###..#.#..##..#.#.....#
.#......#..##.#.##...###.......#.##...###.#.#..####..#......
.##.##....#.....##.....#...####......###..#...##.#.........#
.#.##....###..##.......#.#.##.....#...#.#.#.#.###.#...###...
.......##..#..#####~~~.####..###..###..###..#####..#..##....
##.##.#.....#.#####~S~#.####.###.####.####..###..#..#.....#.
#..##.##.#....#####~~~.####.####..###.#####.####.##..#.#..#.
#.#....#...#.#............#...###..#.##.......#......##.....
##.....##....#...#....##.##......#...##........##...#.###..#
..............###.#########..###..###..####.###.##..#.......
...##...#.#..####..###..###.####..####.####.###..##.#...#.#.
###....##.##.####..###..###..###..###.####..####.###.#..#...
.....##.#.....#..####...#......#..#.#...#..#..#....#.###.###
..#.#....#.#.....##..#........#.#.........#.....#.#.#.##.##.
...#.#.#..#...####.###.##############..###..~~~.##.....#.#..
...#.#.#..##..###.####..###..###..########..~S~.......#.#.##
.......#..#.#####..###.####..###.#########.#~~~...#.......#.
..#.##.#....#.....##......#.#.#....#..#..###...#...#..##..##
.....##.#..#...#..##.#..#.#.##..##....#.##..###..#.#.##..##.
.....#..#....####.#####.####.~~~#####.####.####.###...##.###
..........##.####.####..###..~T~.#####.###..####.....#.#.#..
..##...#.....####.####.######~~~.#####.###..####.#.#.####.##
##..#.#.....#.#......#...........##.###.###.....##.....#..#.
.###.#.#.#..#.#.##..###...##.##..###..##...#...#......#..#..
##....#.#..###~~~..###..########..####.####.####.....####.#.
.....#....##..~S~#.####.####.########..####.###.#.#.##......
.#..#...#.....~~~#.#############..###.#########...#.#..##.#.
##...###..##.......#.#..#.##..#..#.##.#.....#.##.#...#####.#
..#....#.#.####....###...#.##...#...#..#...#..#.........#..#
..###......#..###..#########.###.#####.####.#####......#....
..#..##.#.#..####..###.####..###.####.###########...#..#.##.
..#.#...#.#...####.###.####..###..########.####.....#.##..##
#.......###..#.#..#...#..#....#.#..#...###..#.#.#######.#.#.
....#..#.#.#...#.#...#....##..#.#.##.#.#........#....##.#...
.#####..##.#..####.####.###..###.#~~~######.###.#..##.#...#.
.##.##..#.###.###.#####.###.#####.~S~..###..###.####........
##.#..#..#...#####.###.#####.###.#~~~..###.######..#..#....#
#.#####......###.....###.#........#..#..#...........#....#..
.#.#.......#.....#..#.#.#.#....##....#........#..#..###.....
.............#..#........#....##..###...#.....#.#.#.#.###..#
##.#....#..##..#..#....#.#..##..##.####...###...#.#.##..##..
#....#.....##.....#....#..#..##..#.......#...##.#.###..#.##.
..#.#..#..#...#.....#.#####.........#.#.###...#.##......#..#
.....#..##.##....###.###..##.....##..#.#.#..#....#...#.#.##.
.........###.#..#.#.....#...........#..#.#.#..##.#.#.....#.#
..#..#.#..#..#....#.....#.#.#.##.........###.......#........
#..#.#.##.#......#.#..#....###.#.###.##.#.#.#.#.....#.....#.
..#.....#.###......#.###.....##..#...##...#.#.#..........#..
#..#..#.###.###.....#..##.........#.#...###.......#..#.....#
#........#......###........#.#...#....###..####..#..........